1111111111111111111111111111111111111111
1P00000000000000000000000000000111111111
11111111111111111111111111110000M0000001
1000000000000000000000M00000001111111111
100000000000000000000000000000C011111111
1111111111111111000000000000000000000001
1100000000000000011111111111111111111111
1001000000000000010000000000000000000001
1111000M00000000010000000C00000C00000001
11111100000000000100000C000C0C000C000001
1100000M0M000000010000C00000C00000C00001
1000000MEM00000001000C0000000000000C0001
10000000M0000000010000C00000M00000C00001
1000100000000M000100000C000000000C000001
11011000000000000100M000C0000000C0000001
110M000000000000000000000C00000C00000001
10000000000000000100000000C000C000000001
100100000M00000001000000000C0C0000000001
10110000000M00000100M0000000C00000000001
10M00M0000000000000000000000000000000001
1111111111111111111111111111111111111111
