11111111111111111111111111111
10000000000000000000000000001
10000000000M0000000000000P001
10000000M11110000000000000001
10000000011110000000000000001
1000000001111M000000000000001
1000000000M000000000000000001
10000000000000000000000000001
1CCCCCCCCCCCCMCCCCCCCCCCCCCC1
1CCCCCMCCCCCCCCCCCCCCMCCCCCE1
11111111111111111111111111111