1111111111
1PEC111111
1C11111111
10000F0001
1111111111