11111111111111
10000000000001
1100000000C011
10000000000001
100000000P0001
11111001111111
11100000101111
10000000000111
11110000111111
11111111111111