11111111111111
10C00000000001
1100000000E011
1000C000000C01
10C000000P0001
11111001111111
11100000101111
100C0000000111
1111000C111111
11111111111111