1111111111111111111111111111111111111111
100P000000000000000000000000000000000001
1000000C00000010000001111111110000000001
1000000000000011000000000000001000000001
1000000000000101000000000000001000000001
1000000000001001000000000000001000000001
100000000001000100000C0000000010000C0001
1000000000100001000000000000001000000001
1000000001000001000000000000001000000001
1000000010000001000001111111111000000001
1000000100000001000001000000000000000001
1000001111111111110001000000000000000011
1000000000000001000001000000000000000C01
1000000000000001000001000000000000000001
1000000000000001000001000000000000000001
1000000000000001000001111111110000000001
100000C000000000000000000000000000000001
1111111000000001111111111111111111111111
1CC000000000000000000000000000000000E111
1CC0000000000000000000000000000000001111
1111111111111111111111111111111111111111