11111111111111111111111111111
10000000000000000000000000001
10000000000C0000000000000P001
10000000C11110000000000000001
10000000011110000000000000001
1000000001111C000000000000001
1000000000C000000000000000001
10000000000000000000000000001
1CCCCCCCCCCCCCCCCCCCCCCCCCCC1
1CCCCCCCCCCCCCCCCCCCCCCCCCCE1
11111111111111111111111111111