11111111111111111111111111111111111111111111111111111
1P000000000000000000000000000000000000000000000000001
10000000000000000000000000000000111000000111111110001
1001CCCCCCCCCC100000000000000011100000011100001110001
10000000000000000000000000001110111000000000111000001
10011111111111110000000000111001110000000111000000001
10000000000000000000000011111111111000111000000000001
10011111111111111111000000000111000011100000000000001
10011111111111111111000000001110001111111111100000001
100000000000000000000000000000000000000000000000000E1
11111111111111111111111111111111111111111111111111111