11111111111111111111111111111111111111111111
1E0000000000000000000P00C000000000C000000C01
11111111111111111111111111111111111111111111