11111111111111111110000111111111111111111111111111111111
10000000000000000000000000000000000000000000000000001
10000000000000100000000000001111111110000000000000001
10000000000001100000000000000000000001000000000000001
10000000000010100000000000000000000001000000000000001
10000000000100100000000000000000000001000000000000001
1000000000100010000000000000000000000100000000000001
10000000010000100000000000000000000001000000000000001
10000000100000100000000000000000000001000000000000001
10000001000000100000000000001111111111000000000000001
10000010000000100000000000001000000000000000000000001
10000111111111111000000000001000000000000000000000011
10000000000000100000000000001000000000000000000000001
10000000000000100000000000001000000000000000000000001
10000000000000100000000000001000000000000000000000001
10000000000000100000000000000111111111000000000000001
10000000000000000000000000000000000000000000000000001
10000000000000000000000000000000000000000000000000001
10000000000000000000000000000000000000000000000000001
1000000000000000000000000000000000000000000000000001
10000000000000000000000000000000000000000000000000001
10000000000000000000000000000000000000000000000000000001
10011111111111111111111111111111111111111111111111
10000000000000000000000000000000000000000000000000001
10000000000000000000000000000000000000000000000000001
100000000000000000000000000000000000000000000000011
100000000000000000000000000000000000000000000000111
11111111111111111111111111111111111111111111111111111