1111111111
1PEC111111
1C11111M11
10000M0001
1111111111