11111111111111111111111011111111111
100000000000000000000000000C0000011
10000000000000000000000000000000000
10000000000000000000000000000000011
10000000000000000000000000000000011
1000000000P000000000000000000000011
10000000000000000000000000000000011
10000000000000000000000000000000011
10000000000000000000000000000000011
100000C00000000000000E0000000000011
00000000000000000000000000000000001
11111111111111111111111111111111111
11111111111111111110111111111111111