11111111111111
10000000000001
110011000000E011
100001111000000001
100000000P0001
11111001111111
11100000101111
1001100000000111
1111000C111111
11111111111111111111