11111111111111111111111111111111111111111111111111111
100P0000000000000000000000000000000000000000000000001
10000000000000100000000000001111111110000000000000001
10000000000001100000000000000000000001000000000000001
10000000000010100000000000000000000001000000000000001
10000000000100100000000000000000000001000000000000001
10000000001000100000000000000000000001000000000C00001
10000000010000100000000000000000000001000000000000001
10000000100000100000000000000000000001000000000000001
10000001000C00100000000000001111111111000000000000001
10000010000000100000000000001000000000000000000000001
10000111111111111000000000001000000000000000000000011
10000000000000100000000000001000000000000000000000C01
10000000000000100000000000001000000000000000000000001
10000000000000100000000000001000000000000000000000001
10000000000000100000000000000111111111000000000000001
10000000000000000000000000000000000000000000000000001
10000000000000000000000000000000000000000000000000001
10000000000000000000000000000000000000000000000000001
10000000C00000000000000000000000000000000000000000001
10000000000000000000000000000000000000000000000000001
10000000000000000000000000000000000000000000000000001
10011111110000000111111111111111111111111111111111111
10000000000000000000000000000000000000000000000000001
10000000000000000000000000000000000000000000000000001
1000000C000000000000000000000000000000000000000000011
1000000000000000000000000000000000000000000000000E111
11111111111111111111111111111111111111111111111111111